20|30|50|
19|30|50|
19|29|50|
19|29|49|
19|29|48|
19|29|47|
18|29|47|
18|29|46|
18|29|46|
18|28|46|
18|29|46|
18|29|46|
18|28|46|
18|29|46|
